11111111111
1P0000C00001
1000E00000000c1
11111111111