111111111111111111
100000C000000N0001
100001000000N00C01
100P000000000N0001
100000C0000000N001
10000000111000N0E1
111111111111111111