11111111111111
10P00000010001
1000C00010E001
1000000C1000C1
11111111111111