11111111111111111111
100000000N0000000001
1P0000000N000E000001
100C00000N000C000001
11111111111111111111