11111111111111
10P00000010001
1000C000100001
1000000CE000C1
11111111111111