11111111111111111111111111111111111111111111111111111111
100000001000N0001111000C001000N0000C00010100001111100111
1000100000C000101000111100000001100000100000001N11100001
1000N0000000000NN0000C00000010000000011000N0000C00000E01
100000000C0000000000000011000000000000000010000000000001
1000P00000000000N00000N00000000NNN0000000000000000011111
1000000001000001000000000C000000001111110000000000000101
11111111111111111111111111111111111111111111111111111111
