11111111111111111111111111111111111111111111111111111111
100000001000N00011110000001000N0000000010100001111100111
10001000000000101000111100000001100000100000001N11100001
1000N0000000000NN0000000000010000000011000N0000C00000EC1
10000000000000000000000011000000000000000010000000000001
1000P00000000000N00000N00000000NNN0000000000000000011111
10000000010000010000000000000000001111110000000000000101
11111111111111111111111111111111111111111111111111111111
