1111111111111
1001000000C01
1000011111001
10P011E0000P1
1111111111111