11111111111111
10P000001100E1
1000C000100001
1000000C010001
11111111111111