111111111111
10E0000P0001
111111111111