1111111111111111
10000c00000000e1
1p00111110000001
10001c0000c00001
1111111111111111