1111111111111111
10000C00000000E1
1P00111110000001
10001C0000C00001
1111111111111111